ACDT=Australia/Adelaide
ACST=Australia/Darwin
AEDT=Australia/Sydney
AEST=Australia/Queensland
AKST=America/Anchorage
AST=America/Puerto_Rico
AWST=Australia/Perth
CAT=Africa/Blantyre
CET=Europe/Berlin
ChST=Pacific/Guam
CST=America/Costa_Rica 
EAT=Africa/Nairobi
EET=Africa/Cairo
EST=America/New_York
HKT=Asia/Hong_Kong
HST=/Pacific/Honolulu
IST=Asia/Calcutta
JST=Asia/Tokyo
KST=Asia/Seoul
MSK=Europe/Moscow
MST=US/Mountain
NST=Canada/Newfoundland
NZDT=/Pacific/Auckland
PKT=Asia/Karachi
PST=US/Pacific
SAST=Africa/Johannesburg
SST=US/Samoa
WAT=Africa/Lagos
WET=Europe/Lisbon
WIB=Asia/Jakarta
WIT=Asia/Jayapura
WITA=Asia/Makassar